                            
                            
                            
1222222222222222222222222223
6                          6
6                          6
6                          6
6                          6
6                          6
6                          6
6        2222222222        6
6                          6
6                          6
6                          6
6                          6
6                          6
6                          6
6                          6
6                          6
6                          6
6                          6
6                          6
6                          6
6                          6
6      222222222222        6
6                          6
6                          6
6                          6
6                          6
6                          6
6                          6
6                          6
6                          6
6                          6
6                          6
7888888888888888888888888889